111111111
1110N0111
111100000111
   111111111
   1111111111