111111111111111111                       
11111111111110001
1111110N111
111111101
1111111111111111111111111111111111