11111001001001
11111001001001
1001000001
11111001001001
11111001001001