111111111
111000111
111100011111
   111N000001
   1111111111