    111
1111000111
1001000001
1011100001
1000000001
1000011001
1000011001
111P000001
1000000001
1111111111
1
1
11111111
11110011

