111111111
111N00111
111100011111
   1110000001
   1111111111