11111001001001
11111001001001
10010N0001
11111001001N01
11111001001001