111111111
111000111
1111000N11111
   1110000001
   1111111111