11111111111
10000000001
10000000001
11111110001
10000000001
10000000001
100N1111111
11111