1111111111
1001001001
1001001001
1110011001
1000010001
1010010001
1010000001
1011001001
1001001111
1111111111