1111111111
1001000001
1001000001
1111110001
1000010001
1000010001
1010000001
1011001001
1001001001
1111111111