C 100,100,250
NO maps/textures/mossy.xpm
EA maps/textures/checker.xpm
WE maps/textures/red_brick.xpm
SO maps/textures/wood.xpm
F 150,100,50
111111111111111111111111111111111111111111111111111111111111111111111111111111111111111111111111111111111111111111111111111111111111111111111111111111
100000000000010000000000000000000000000000000000010000000000000000000100000000000000000000100000000000010000000000000000000000010000000000000001100001
100000000000100000000000000000001000001000000000000011000000000010000000000000000000000010000000100001000000000000001000000010000000000000001000000001
100000000000000000000000000000000000000000000001000000000000100000000000000000000010000000000000000010000000000000000000010000000000000000000000000001
100000000000010000000000000000000100000000000000000000000010000000000000000000000000000101000000000001000000001111111111111111111000000000000000000001
100000000000000000000000000000000010000010000000000010010000000000000001000000000000000000000000000000000001001000000000000000001000000000000000100001
100100100000000000000000000000000000000000000000000000000000010000000000000000000000000000100001000000000010001000000000000000001000000001000000000001
100000010000001000000000000000001010000000000000100010000000000010000000000000000000001000000000000000000000001000000000000000001000000000000000000001
100000000000000000000000000000000100000001000000001000000000000000001000000000000000000000000000000000000000001000000000000000001000000000000000000101
100000000101000001100000000000100100000000000000000000100000000000000000000000000000000000000000000000000000001000000000000000001000000000000000000001
100000000000000000000000000000000000000000000000000000000000000000000000000001000000000000000000000000000100001000000000000000001000000000000000000001
100100010000000000000000000000000000000000000000000000000000000000000000000000000000010000000000010000000100001000000000000000001000000000010000100001
100000001001000000000000000000000000000000000000000000000001000000010000000000000000000000000000000000000100011000000000000000001000000010000000000001
100000000000010000000000000011111111100000000000000000001000000100000001000000000010000000000010001000000000001000000000000000001010000000000000000001
101000000000000001000000000010000000100000000000100000000000000000000000000000000000011111111111111111111110011000000000000000001000100000000000000001
100000000000000000000000000010000000100000010010000000000010001000000000000010010001010000000000000000000100101000000000000000001000000000010000000001
100100000000010000000000000010000000100000000000001000000000000000000000000000010000010000000000000000000100001000000000000000001000000000000000000011
100000000000000010000000000010000000100000000000000000000000000000000000000001000000110000000000000000000101001111111111111111111000000000000000000001
100000100000000000000000000010000000101010000000000000100000000100000000000000000000010000000000000000000100000000000000000000000010000000100000000001
100000000100001000000010010010000000100000000000000000000000010000000000000000011000010000000000000000000100000010000000000000010000000000000000010001
100000000000000000001001101010000000100000000000000000000000000000000000100001000000010000000000000000000100000000000100000000000000000000000010000001
100000000000000000000000000010000000100000000010000000000011000000000100000000010000010000000000000000000100010000000000100000000000000000000000010001
100000000000000100010000000010000000100000000000000000000000000000110000000001000000010000000000000000000100000000100000000000000000000000000000000001
100000000000000000000000000010000000100001000000001000000100000100000000000000000000010000000000000000000100001010000000000001000000000000000000000001
100000010000000000000000000010000000100000000100000000000000000000100000000000000000010000000000000000000100000000000000000110000000000000000000001001
100000000100000000000000000010000000100000000000000000000000000100000000000000000000010000000000000000000100010000000100000000000000000000000000010001
100000000000000000110000000010000000100000000000001000001000000000100000000000000000010000000000000000000100000010000000000000000010000001000000000001
100000000000000000000000000010000000100000000001000010000000000000000000001000000001010000000000000000000100010000000000000000000000001000000000000001
100000000001000000000100000110000000100000000000010000000000010000000000000000100000010000000000000000000100000000000000000001000000000000000000000001
100000000000001000001010000010000000100000000000000000000000000000100000001000000100110000000000000000000100000000000000000000000000000000000000000001
100001000000000000000000000011111111100000100000000001000000000000000000000000000000010000000000000000000100000100000000000000000000000000000000000001
100011000100001000000000000100000001000000000000000100000000000000000000000000000000010000000000000000000101100000010000000000000000000000000000000001
100000000000100000000101000000000001000000000000000000000001000000000000000000000000010000000000000000000100000000000000001000000000000000000000000001
100000000000000000000000101000000100000000000000000000000000000000000000100000000000010000000000000000000100000000000000010000000000000000000000000001
100000000000000000001001000000000000000000000000100000000000000000000000000000000000011111111111111111111100000100000000000000000000000000000000000001
100000010010000000000001000000000000000000000000000000000000000000000000000010000000000000000000000000000000000000001000000000000000000000000000000101
100000000000000000001000100000000001000000000000000000000000000000000000000000000001000000010000000000000000000000001000000000000000001000001000000001
100000000000000000000000000000000000000000000000000000000000000010101000000000000000000000000010000000000000000000000000000000000000100000000010000001
100100000000000000000000000000000001000000010000000000001000000000000000010000000000000000000000000000000000000000000000000000000010000100000000000011
100001001000100000000000000000000000000000000100001000000100000010000010000000001000000000100000000000000000000001000000000010000000000000000000000011
100000000000010000000000000000000000000000000000000000001000000000001000000000100000000001000000000000000000000000000000100000010000000000000000000001
100000000000000000000000000000001000000000000000000000000000000000000000000000100000000000000000000000000000000100000000000000000000001000000000100001
110000000000000000000010000000000000000000000000000000000010000000100000000000000001000000000000000000000000000000000000000001000000000000000000000001
100000000000000000000000010000000000000100000000000000000001010000000000000000000010100000000000000010100000000000000000000000000001000000000000100001
100000000000000000000100000000100000000000000001000000000000000000000000001001010000000000000000000000000000000000000000100000100000000000001000000001
100000000000000000000000000010000000000000000110000000000000100000000000000000000101000000000000000010000000000000000000000000000000000000000000000001
100000000000000000000000000000000000000000000000000000000000000000000000000000000000000000000000000000100000000000000000000101100000000001000000000001
100000000000010000001000000000000000000010000000000000000000000000000000000000000000000000000000000000000000000000000001000000000010000000001000000001
100000000000010010000000000000000000000000001000100000000000000000000000000000000000000001000000000000000001000000000000000000010010010000000100000001
100000100000000000000000000000000000000000000000000000000000000000000000000001000000000000000000000000000000000000000000000000000100000000000000000001
100000000000000000000000000000000000000000000000000000010000000000000000000000000000000000000000000000000000001000000000000000001000001000000110000001
111000000000000000000000000010000000000000000000001000000000010000000100000000000000000000000000000000000000000000000100000000000001000000000010000001
100000000000100000010000000000000000000000000000000000000000010000000000000000000000000000000000000010000000100000000000000000000000000000000000000001
100000000000000000000000000000000010000000000100000000000000000000000000000010000000000000000010000000000000011000000000000001000000000000100100100001
100010000000000000000000100000000000000000000000000000001000000100000000001000000000000000000000000000000000000000000000000010000000000000010000000001
100000010100000000100001000010001000000000000000000000000000000100100000000000000000000000000000000000000000000000000000000000000000000000000000000001
100000000100000000000000000000100000000000010001000100000000000100000010000000000001000000001000000000000000000000000000000010000000000000000000001001
100000000000110010000100000000000000000000000000000000000000000000000000010000000000000000000100010000000000000100000000000000001000000000000000000001
100100010101000001000000000000000000000000000000000000000000000000000000000000000000000000000000000000000000000000000000000000000000000000000000000011
100010000000001000000000000000000000000001000000000000000000001000000000000000100000100010000000000000000000000000000000010000000000000000000000000001
100000000000000000000010000000000000001000000000000000000000100000100000000000000000000000000000000000000000000000000100000000000000001000100000000001
100000000000000100000000000000000000000000100100000000000000001000000000000000000000000000000000000000000000000000000000000000000000000000000000000011
100000000000000000000000000000100100000000000000000000000000000000000010100000000000000000000000100010010000000000000100000001010000010000000000000001
100000000000000000000000000000000000000000000101000001010000000100000000000000000000000000000000000000000000000100000000000000000001000000000000000001
100000000000000000100000000000000000000000000000000000100000000000000000000000000000000000001000000000000000000000000000100000000000000000000000000001
110000000000000000000000100000000000000000000000000000000000000000000000000000000000100000000000000000000001111111111111111000000000000000000000000001
100000000000000000100000000000000000000000000000000001000000000000000100000000000000000000000000001010000001000000000000001000000000100000000000000001
100000000100000000000000000000000001000000000000000000000000000000000100001000000000000000000000000000000001000000000000001000000000000000000000000001
100000000000000000000010000000000000000000000000010000000000000000010000100000000000001100000000000000000001000000000000001000000000000000000000000001
100000000000000000000000000000000010000000000000000000000000000000000000000000000000000000010000000000000001000000000000001000000000000000100000000001
110000010100010000001000100000000000000000010000000000000000000000000000100000000000000000000110000000000011000000000000001100000000000000000010000001
100000000000000000000000000000000000000000000000000000000111000010000010000000011100000000000000000000100011000000000000001100000000000000100000000001
100000000000000110010000000000000000000000000000000000000000000000000000000000000000000000000000000000000011000000000000001100001000000000000000000001
100001000000000000100000000000010000000000000000000000000000000000000000000000000000000000000000000000000011000000000000001100000000100010000000000001
100000000000000000000000000001000000000000000001001000000000000000000000000000000000101000000010000100010011000000000000001100000000000000000000000001
101000000000000000000000000000000000000000000000000000000000010000000000000000100010000000000000000000000011000000000000001101000000000000000000000001
101000100000010000000000000000000000010000010000100100000000000000100000000000000000000000000000000000000011000000000000001100000000000000000010000001
100000000001000000000000000000000000010000000000000000000000000000000000000000000000000000001000100000000011000000000000001100000000000000000000000001
100000000000000001000000000010000001000000000100000100000100000000000000000000000000000000000000000000000001000000000000001010000000000000000001000001
100000000000000000000000001000000000000010000000000000000000001000000000000000000000000000001001000000000001000000000000001000000000000000000000000001
100000000000000000100000000000000000000000000000000000000000000000000000000000000000000000010000000000000001000000000000001000000000000000000000000001
1000000000000000000000000000000000000000000000010000000000000000000000W0000000000000000000000000000000100001000000000000001000000000000000000000000001
100000000000000000000000000000000000000000000000000000000000000000000000000000000000000000000000000000000001000000000000001001000001000000000000000001
100000000000000000000000000000000000000000000000000000000000000000000000001001000000000000000000000000000001111111111111111000010000000000000000000001
100000000000000000000000000000000101000001000000000000000010011000000000000001000001000000000000000000000000000010000000000000000000000000000000000001
100010100000000000000000001000000000000000000000000000000000000000000000000000000001000000000001000000000000000000000000000000000000000000000000000001
100000100000010000000000000000000000000000001000000100000000000000000000000000000000000000001111111111111111100000000000001001000000000000000000000011
100000000000000000000000000100000000000000000000000000000000000000000000000000000000000000001000000000000000100000000000001000000000000010000000010001
100000000000000000010100000001000010000000000000000000000010000000001000000000000000000001001000000000000000100000010000000000000000000010000000000001
100000000000000000000000000000000000000000001000000000000000000000000000000000100000000000011000000000000000100000000001000000100000000000000000000011
100000000000000000000000010000000000000000000000000000000000000000000000000000000000000000001000000000000000100010000000000000000011111111111111111101
100000000000000000000000000000000000010000001000000000000000000000000000000000000100000001001000000000000000110000000000000000000110000000000000000101
100000000000000001000000000100000000000000000000000000000000000000000010000000000000000000001000000000000000100000000000010000001010000000000000000111
110000000000000000000000000000010000000000000000000000000000000000000000000000000000000000001000000000000000100000000000100000000010000000000000000101
100000000000000100000000000000000000000000000000000000100000000000000000000000000000000000001000000000000000100000100000000100000010000000000000000101
100000000000000000000000000000000000000000000000000000000000000000000000000000000000000000001000000000000000100000000000000000000010000000000000000101
100000001000000000000000000000000000000001000000000000000000000000000000000000000000000000001111111111111111100000000000000000000010000000000000000101
100000000000000001000000100000001000000001000000000000000000000001000000000000000000000000001000000000000001000000000010000000000010000000000000000111
110000001000000000000000000000000000000001000000000000000010000100000000000000000000000000000001000000000000000000001000000000000010000000000000000101
100000000000000000000000000000000000000001000000000000001000000000001000010000000000000000000000000000000000000000000000000000000010000000000000000101
100000011000000000000000000000000000000000000000000000000000000000000000000000000000000000000001000000000010000000000000000001000010000000000000000101
100000000000000000000000000000000000000000000000000000010000001000000000000001000000010000000000000010000000000010000000000000000010000000000000000101
100000001000000000000000000001000000000000000000000000000000000001000000100100000000000000000000000000000000000000001000000000000010000000000000000101
100000000000000000000000000000000000100000000000000000000000000001110000000000000100000100000000000000000000000000100100000000000010000000000000000101
100100000000001000100001000000010000100000000000000000000001000000001000000000000000000000000010000000000000000100000000100000000010000000000000000101
100000000000000000000000000000000000000000000010100000000000000000000010000000000000000000000000000000000000000000000000000000000010000000000000000101
100000100010010010000000000000000000010000000000100000000010000000000000000000000000010000000000000000000000000000000000000000000110000000000000000101
100000000000000000000000000000000000010000000000000000000000000000100000000000000010001000000000000000000100000000000000000010001010000111111111111111
100100000000000000001000000000000000000000000000000001100000000000000000000000000100010000000000000010000000001000010000000001000011111100000000000011
100000000000000000001000000000000000000010000000000000000000000000000000000000000000000000000000000000000000000000010100010000100000000100000000000011
101111111111111111111000000000000000001000001111111111111111111100000000000000000000000000000000000000100000000000000000100000000000000100000000000011
101000000000000000001000000000000000100000001000000000000000000100000001011000000000000000000101000000000000000000000000000000000000000100000000000011
101000000000000000001000000000010000000000001000000000000000000100000000000000000000000000000000000000000000000000000000000000000000000100000000000011
111000000000000000001000000000000000000000001000000000000000000100001000000000000001000001000000000000000000000000000000000000011000000100000000000011
101000000000000000001000000000000000000010001000000000000000000110000000000000100000001000000000000000000000000001000000010000000000000100000000000011
101000000000000000001000000000000000000000001000000000000000000100000000000000000000000000000000010100101000000110000000011000000001000100000000000011
101000000000000000001000001000000000010000001000000000000000000101000000000000010010000000000000000000000000000000011000000000000000000100000000000011
101000000000000000001000000000001010100000001000000000000000000101000000000000000000000000000000000000000000000000000000000000000000000100000000000011
101000000000000000001000000000000000000000001000000000000000000100000000000000000000000000000000000000000000000000000000000000000000001100000000000011
101000000000000000001000000000000000000000001000000000000000000100000000000000000000000000000000000010000000000000000000000000000000000100000000000011
101000000000000000001000000000000000000000001000000000000000000100000001010001100000100000000000000100000000000000000000000000000000000100000000000011
101000000000000000001000010000000000000000001000000000000000000100000000000000000000100000010000010000000000001000001000000000000000000100000000000011
111000000000000000001001000000010000000000001111111111111111111100000000000000000000000000000000000001000000000010000000000000000000000100000000000011
101111111111111111111000000010010000000000000000100000000000000000000010000000000000000000000000000000000000000000100000000000100000100100000000000011
100000000000000000000000010000000000000010000000000000010000000000000100000000001000100000000000000000000000000000000001000100000000100100000000000011
100000000000000000000100001000000100000000000000000000000000000001000000000000010000001000000000000010000000000000000000010000000000000100000000000011
100000000000000000000000000001000000000000000001000000001000000001000000000000000000000000000000001000000000000000000000000100000000000100000000000011
100000000000000010000000000000000000010000100000000000000000000100001000000001000000000000000000000000000000000000000000000000000000000100000000000011
100000000100000000000000000100000000000000000000000000000100000000000000000000000000000000010000000000100000000000000010100000000000001111111111111111
100000000000000000000010000000000000000000000000000000000010001000000000000000000000000000000000000000000000000000000000000000000001000010000000000001
100000000000000000000000000000000000000001000010000000000000000000000000000000000010010010000000000000000000000000000000000000000000000000000000000001
100000001010000001001000000000000000000000000000000000100000000000000000010000010000000000000000000000000000100000000000000000000000000000000000000001
100000000000000001000001000000000000000000000001000100000000000000000000000000010000000000000000000000010000000000000000010000000000000000000000000101
100001000000000000000000000000000000000000000000000000000000100000000000000000000000000000000000000010000000000000000000010000000000000000000000000001
100000000000001000000000000000001000000010000000000100000000000000000000000000000000000000000000000000010000000001010000000000000000000010000000010001
110000000000000000000000000000010000000000000000010000000001000000000001000000000000000000000000000000000000000000000000000000000000000000000001000001
100000010000000000000000000000000000000000000110000000000000000000100000000000000000000000000000000000000000000000000100000100000000000000100000000101
100000000000000000000000000010000000000000000000000000000000000000010110000000000000000000000000100000000000000000000000000000000001000100000000000001
100000000000000000000000000100000000000000000000000000001000000000010000001000000001000000010000000000100000000000000000000000000000000000000000000001
100000000000000000100000000000000000000000000000000000000000000000000000000000000000000000000000010000000000001000001001000000000000000000000000000001
100000000000000000000001000000000000000000000001000010000000001000000000000000000010000000000000000000000000010000000100000000000000000000000000000001
100000100000001000000000000100000000001000000000000001000000000000000000000000001100000000000000100000000000000000000000000000000000000000000100000001
100000000000000000000000000000000000000000010000000000000010000000000000010000000000000000000000000000000000000000000000000000000000010000000000000001
100000000000000000000000000000000000000000000000000000000000000000000000010000000001000000000000000000000000000000000000000000100100010101000000000101
100000000000001010000000000000000000001000000000000001000000000000000000000001000000010000010000000000000010010000010010000000000010100000100000000011
100000000000000000000000100000000000000001010000000000001001000000000000000000000000000000000000000000000000000000100000000000000000000000000000000001
100000000000101000000000000000000100000000000000000000000000000000100000000000000000001000000000000010000000100000000000000000000000000000000000000001
100000000000100001000000000000001000000000000000010000000000100001000010000000000000000100000100000000000000000000000000000000000000000000000000000001
100000000000000000000000000000001000010000000000000000000000000000000000000000000000000000001000000100000000000000000000000000000000010000000000001001
111111111111111111111111111111111111111111111111111111111111111111111111111111111111111111111111111111111111111111111111111111111111111111111111111111
