
    C 8,8,8
 
 SO s

 NO maps/textures/grass-block_16.xpm


111111111
1110S01111
111100000111
   111111111
   111111111
