F 100,100,100
NO maps/textures/mossy.xpm
EA maps/textures/checker.xpm
WE maps/textures/red_brick.xpm
SO maps/textures/wood.xpm
C 100,100,100

11111111
10S10100
10100001
