C 100,100,250
NO maps/textures/mossy.xpm
EA maps/textures/checker.xpm
WE    maps/textures/red_brick.xpm
SO maps/textures/wood.xpm
F     150,100,50


1111
100011111111
1000000000N1
101011
111111
