C 100,100,250
NO maps/textures/mossy.xpm
EA maps/textures/checker.xpm
WE    maps/textures/red_brick.xpm
SO maps/textures/wood.xpm
F     150,100,50

1111111
100000011111
100000000001
1110000000011
0 100001111
  100001
11100001
1E000001
11111111