
 
 F 33,3,3

NO abc


    C 255,15,1


111111111
1110S01111
111100000111
   111111111
   111111111
