C 100,100,250
NO maps/textures/mossy.xpm
EA maps/textures/checker.xpm
WE maps/textures/red_brick.xpm
SO maps/textures/wood.xpm
F 150,100,50

11111111
10N10101
10100001
10000001
11111111
