
NO maps/textures/mossy.xpm


EA maps/textures/wood.xpm
SO maps/textures/mossy.xpm
F     150,100,50
C     0,0,0
WE    maps/textures/mossy.xpm

11111111
100000011111
100000000001
1110000000011
0 100001111
   10001
01110001
1E000001
01111111