F 0,0,0
NO maps/textures/mossy.xpm
SO maps/textures/purple_stone.xpm
WE maps/textures/red_brick.xpm
EA maps/textures/wood.xpm
C 0,0,0

11111111
10S00111
11111111

