NO maps/textures/diamond.xpm
EA maps/textures/grass-block_16.xpm
SO maps/textures/TNT.xpm
WE maps/textures/grass-block_16.xpm

F     95,159,53
C     0,204,255

11111111
1000000111111111111111
1000000000000000000001
1110000000000000000001
0 10000111110111111011
   10001  1101    101  
01110001  1001    101
10000001  1111    101111
01111111          1000W1
                  111111