
NO maps/textures/mossy.xpm
SO maps/textures/purple_stone.xpm
WE maps/textures/red_brick.xpm
EA maps/textures/wood.xpm
C 0,0,0
F 0,0,0

               11111111111
              1000000000001
             11000000000N01
            100000000000001
            101111011111111
          11101  101
         100001  1011111
         101111  10000001
         10111    1111101
         100001       101
         101101       101
        1101101111111110111
        10000000000000000001
         1000000000000000001
          110001111110000001
           10001     10000001
           10001     10000001
           10001     10000001
           10001      1111001
           10001         1001
           10001         1001
           10001         1001
           10001         1001
           10001      111100111
           10001     100000000011111
           10001     1000000000000001
           10001     100001111111111
      1111110001     10001
     10000000001     10001
     10111100001     10001
     101  100001     10001
     101  100001     10001
     101  100001     10001
     101  100001     10001
     101  100001     10001
    1000000000000000000001
    1000000000000000000001   
     10111111111111110011    
     101            1001     
     10111111111111 1001     
     10000000000001 1001
      11101111111011100111111111
        101  10000000000000000001
        101  10000000000000000001
        101  10011111111111111001   
        101  1001            1001   
        101  1001            1001   
        101  1001            1001   
        10111100000000000    1001   
     11110000000000000000    1001   
     10000000000000000000   11001   
     1000000000000000000000000001   
     1000000000000000000000000001   
     1000000000011111111111101011  
      10000000001           1101111
       111111111             100001
                             100001
                              11111