NO maps/textures/north.xpm
SO maps/textures/south.xpm
WE maps/textures/west.xpm
EA maps/textures/east.xpm
F 220,100,0
C 225,30,0
111111
100001
101N01
11X001
111111