NO maps/textures/north.xpm
SO maps/textures/south.xpm
WE maps/textures/west.xpm
EA maps/textures/east.xpm
F 220,100,0
C 225,30,0

111111
100N01
10S001
110001
111111
